1111111111
100E0PC001
11111000E1
100E0C1111
1111111111
