1111111111111111111
10C110C000E000111C1
10E0001110111011001
100P1C000C000000001
111111000000C000101
1E00C000011110000C1
1111111111111111111
