1111111111111111111
10C010C000C000100C1
1010001110111011001
10001C000C000000001
11111100PE00C000101
1100C00001111000CC1
1111111111111111111
