1111111111111
1000P0EC00001
11CE000001011
10000C01E0001
1111111111111