11111111
1E00C011
100EP011
11111111
        