111111111111111111111
100CE00P00C000C0000E1
111111111111111111111
